#........................#.....#
#..............................#
#..............................#
#..............................#
#....................#.........#
#..............................#
#..............................#
#..............................#
#...............#..............<
#..............................#
#..............................#
#..............................#
#..............................#
#....................#.........#
#..............................#
#..............................#
#..........................#...#
#..............................#
#..............................#
#....................#.........#
#..............................#
#..................p...........#
>..............................#
##########....##################