.........................#......
#..............................#
#..............................<
#..............................#
#....................#.........#
#..............................#
#..............................#
#..............................#
#...............#..............#
#..............................#
#..............................#
#..............................#
#..............................#
#....................#.........#
#..............................#
#..............................#
#..........................#...#
#..............................#
#.....p........................#
#....................#.........#
#..............................#
>..............................#
#..............................#
################################