#........................#.....#
#..............................#
#..............................<
#..............................#
#....................#.........#
#..............................#
#..............................#
#..............................#
#...............#..............#
#..............................#
#..............................#
#..............................#
#..............................#
#....................#.........#
#..............................#
#..............................#
#..........................#...#
#..............................#
#.....p........................#
#....................#.........#
#..............................#
>..............................#
#......b......d................#
##########....##################