################################
#..............................#
#..............................<
#..............................#
#..............................#
#..............................#
#..............................#
#..............................#
#..............................#
#..............................#
#..............................#
#..............................#
#..............................#
#..............................#
#..............................#
#..............................#
#..............................#
#..............................#
#.....p........................#
#.#########....................#
#..............................#
>..............................#
#..............................#
################################