#..............................#
#..............................#
#..............................#
#....................#####.....#
#..............................#
#......#####...................#
#..............................#
#..................#####.......#
#..............................#
#.....#####....................#
#......................#####...#
#..............................#
#.............#####............#
#..............................#
#....#####.....................#
#..............................#
#..............#####...........#
#..............................#
#.........................######
#..................#####.......#
#........#####.................#
>..................p...........<
#####..........................#
##########....##################