#........................#.....#
#..............................#
#..............................#
#..............................#
#....................#.........#
#..............................#
#..............................#
#..............................#
#...............#..............#
#..............................#
#..............................#
#..............................#
#..............................#
#....................#.........#
#..............................#
#..............................#
#..........................#...#
#..............................#
#..............................#
#....................#.........#
#..............................#
>..................p...........<
#..............................#
##########....##################